{
  "version": 3,
  "name": "1v1",
  "description": "1v1 map",
  "_design": "Migrated from layout-based map data. Flat map locations are now authoritative.",
  "terrain": [
    "................................................................................................~~~~~~~~~~~~~~~~~~~~~~~~~~~~~~",
    "..................................................................................................~~~~~~~~~~~~~~~~~~~~~~~~~~~~",
    "....................................................................................................~~~~~~~~~~~~~~~~~~~~~~~~~~",
    "......................................................................................................~~~~~~~~~~~~~~~~~~~~~~~~",
    "===============================================================================================........~~~~~~~~~~~~~~~~~~~~~~~",
    "================================================================================================........~~~~~~~~~~~~~~~~~~~~~~",
    "=================================================================================================........~~~~~~~~~~~~~~~~~~~~~",
    "-=-=-=-=-=-=-=-=-=-=-=-=-=-=-=-=-=-=-=-=-=-=-=-=-=-=-=-=-=-=-=-=-=-=-=-=-=-=-=-=-=-=-=-=-=-=-=====........~~~~~~~~~~~~~~~~~~~~",
    "==============================================================================================\\====.......~~~~~~~~~~~~~~~~~~~~",
    "====================================================================================================......~~~~~~~~~~~~~~~~~~~~",
    "================================================================================================\\====.......~~~~~~~~~~~~~~~~~~",
    ".............................................................................................=========........~~~~~~~~~~~~~~~~",
    "..............................................................................................====\\====.......~~.~~~~~~~~~~~~~",
    "...............................................................................................=========......~~~~~~~~~~~~~~~~",
    "................................................................................................====\\====......~~~~~~~~~~~~~~~",
    ".................................................................................................=========......~~~~~~~~~~~~~~",
    "..................................................................................................====\\====......~~~~~~~~~~~~~",
    "...................................................................................................=========.....~~~~~~~~~~~~~",
    "....................................................................................................====\\====.....~~~~~~~~~~~~",
    ".....................................................................................................=========.....~~~~~~~~~~~",
    "......................................................................................................====\\====.....~~~~~~~~~~",
    ".......................................................................................................=========.....~~~~~~~~~",
    "####################....................................................................................====\\====.....~~~~~~~~",
    "####################.....................................................................................=========....~~~~~~~~",
    ".=========................................................................................................====\\====....~~~~~~~",
    "===========................................................................................................=========...~~~~~~~",
    "===========.................................................................................................====\\====...~~~~~~",
    "=-=-=-=-===..................................................................................................=========...~~~~~",
    "===========...................................................................................................====\\====...~~~~",
    "=======|===....................................................................................................=========...~~~",
    ".==========.....................................................................................................====\\====...~~",
    "....===|===......................................................................................................=========...~",
    "....=======.......................................................................................................====|===...~",
    "....===|===........................................................................................................=======....",
    "....=======........................................................................................................===|===....",
    "....===|===........................................................................................................=======....",
    "....=======........................................................................................................===|===....",
    "....===|===........................................................................................................=======....",
    "....=======........................................................................................................===|===....",
    "....===|===........................................................................................................=======....",
    "....=======........................................................................................................===|===....",
    "....===|===........................................................................................................=======....",
    "....=======........................................................................................................===|===....",
    "....===|===........................................................................................................=======....",
    "....=======........................................................................................................===|===....",
    "....===|===........................................................................................................=======....",
    "....=======........................................................................................................===|===....",
    "....===|===........................................................................................................=======....",
    "....=======........................................................................................................===|===....",
    "....===|===........................................................................................................=======....",
    "....=======........................................................................................................===|===....",
    "....===|===........................................................................................................=======....",
    "....=======.........................................~~.............................................................===|===....",
    "....===|===..........................................~~~~..........................................................=======....",
    "....=======..........................................~.~~~.........................................................===|===....",
    "....===|===..........................................~~~~~~~~~~~~~.................................................=======....",
    "....=======..........................................~~~..~~~~~~~~~................................................===|===....",
    "....===|===..........................................~~~~~~.~~~~~~~~...............................................=======....",
    "....=======...........................................~~~~~.~~~~~~~~~..............................................===|===....",
    "....===|===...........................................~~~~~~~~~~~~~~~~.............................................=======....",
    "....=======.........................................~~~~~~..~~..~~.~.~.............................................===|===....",
    "....===|===.........................................~.~~~...~~~~.~~~.~~............................................=======....",
    "....=======.........................................~~~~~~.~~~.~.~~~~~~............................................===|===....",
    "....===|===............................................~~~~~~.~.~~~.~~~~~~.........................................=======....",
    "....=======............................................~~.~~~.~~~~...~~~.~.........................................===|===....",
    "....===|===.............................................~.~.~~..~~..~~~~~~.........................................=======....",
    "....=======.............................................~~~~~~~~~~~~~~~~...........................................===|===....",
    "....===|===..............................................~~~~~~~~~.~~~~~...........................................=======....",
    "....=======...............................................~~~~~~~~.~~~~~~..........................................===|===....",
    "....===|===................................................~~~~~~~~~..~~~..........................................=======....",
    "....=======.................................................~~~~~~~~~~~~~..........................................===|===....",
    "....===|===.........................................................~~~.~..........................................=======....",
    "....=======..........................................................~~~~..........................................===|===....",
    "....===|===.............................................................~~.........................................=======....",
    "....=======........................................................................................................===|===....",
    "....===|===........................................................................................................=======....",
    "....=======........................................................................................................===|===....",
    "....===|===........................................................................................................=======....",
    "....=======........................................................................................................===|===....",
    "....===|===........................................................................................................=======....",
    "....=======........................................................................................................===|===....",
    "....===|===........................................................................................................=======....",
    "....=======........................................................................................................===|===....",
    "....===|===........................................................................................................=======....",
    "....=======........................................................................................................===|===....",
    "....===|===........................................................................................................=======....",
    "....=======........................................................................................................===|===....",
    "....===|===........................................................................................................=======....",
    "....=======........................................................................................................===|===....",
    "....===|===........................................................................................................=======....",
    "....=======........................................................................................................===|===....",
    "....===|===........................................................................................................=======....",
    "....=======........................................................................................................===|===....",
    "~...===|====.......................................................................................................=======....",
    "~...=========......................................................................................................===|===....",
    "~~...====\\====.....................................................................................................==========.",
    "~~~...=========....................................................................................................===|=======",
    "~~~~...====\\====...................................................................................................===========",
    "~~~~~...=========..................................................................................................===-=-=-=-=",
    "~~~~~~...====\\====.................................................................................................===========",
    "~~~~~~~...=========................................................................................................===========",
    "~~~~~~~....====\\====................................................................................................=========.",
    "~~~~~~~~....=========.....................................................................................####################",
    "~~~~~~~~.....====\\====....................................................................................####################",
    "~~~~~~~~~.....=========.......................................................................................................",
    "~~~~~~~~~~.....====\\====......................................................................................................",
    "~~~~~~~~~~~.....=========.....................................................................................................",
    "~~~~~~~~~~~~.....====\\====....................................................................................................",
    "~~~~~~~~~~~~~.....=========...................................................................................................",
    "~~~~~~~~~~~~~......====\\====..................................................................................................",
    "~~~~~~~~~~~~~~......=========.................................................................................................",
    "~~~~~~~~~~~~~~~......====\\====................................................................................................",
    "~~~~~~~~~~~~~~~~......=========...............................................................................................",
    "~~~~~~~~~~~~~.~~.......====\\====..............................................................................................",
    "~~~~~~~~~~~~~~~~........=========.............................................................................................",
    "~~~~~~~~~~~~~~~~~~.......====\\================================================================================================",
    "~~~~~~~~~~~~~~~~~~~~......====================================================================================================",
    "~~~~~~~~~~~~~~~~~~~~.......====\\==============================================================================================",
    "~~~~~~~~~~~~~~~~~~~~........=====-=-=-=-=-=-=-=-=-=-=-=-=-=-=-=-=-=-=-=-=-=-=-=-=-=-=-=-=-=-=-=-=-=-=-=-=-=-=-=-=-=-=-=-=-=-=-",
    "~~~~~~~~~~~~~~~~~~~~~........=================================================================================================",
    "~~~~~~~~~~~~~~~~~~~~~~........================================================================================================",
    "~~~~~~~~~~~~~~~~~~~~~~~........===============================================================================================",
    "~~~~~~~~~~~~~~~~~~~~~~~~......................................................................................................",
    "~~~~~~~~~~~~~~~~~~~~~~~~~~....................................................................................................",
    "~~~~~~~~~~~~~~~~~~~~~~~~~~~~..................................................................................................",
    "~~~~~~~~~~~~~~~~~~~~~~~~~~~~~~................................................................................................"
  ],
  "startLocations": [
    {
      "x": 9,
      "y": 9
    },
    {
      "x": 116,
      "y": 116
    }
  ],
  "baseSites": [
    {
      "x": 9,
      "y": 9
    },
    {
      "x": 116,
      "y": 116
    },
    {
      "x": 39,
      "y": 14
    },
    {
      "x": 86,
      "y": 111
    },
    {
      "x": 68,
      "y": 27
    },
    {
      "x": 57,
      "y": 98
    },
    {
      "x": 91,
      "y": 52
    },
    {
      "x": 34,
      "y": 73
    },
    {
      "x": 86,
      "y": 82
    },
    {
      "x": 39,
      "y": 43
    }
  ]
}
