{
  "version": 3,
  "name": "1v1",
  "description": "1v1 map",
  "_design": "Migrated from layout-based map data. Flat map locations are now authoritative.",
  "terrain": [
    "................................................................................................~~~~~~~~~~~~~~~~~~~~~~~~~~~~~~",
    "..................................................................................................~~~~~~~~~~~~~~~~~~~~~~~~~~~~",
    "....................................................................................................~~~~~~~~~~~~~~~~~~~~~~~~~~",
    "......................................................................................................~~~~~~~~~~~~~~~~~~~~~~~~",
    ".......................................................................................................~~~~~~~~~~~~~~~~~~~~~~~",
    "........................................................................................................~~~~~~~~~~~~~~~~~~~~~~",
    ".........................................................................................................~~~~~~~~~~~~~~~~~~~~~",
    "..........................................................................................................~~~~~~~~~~~~~~~~~~~~",
    "..........................................................................................................~~~~~~~~~~~~~~~~~~~~",
    "..........................................................................................................~~~~~~~~~~~~~~~~~~~~",
    "............................................................................................................~~~~~~~~~~~~~~~~~~",
    "..............................................................................................................~~~~~~~~~~~~~~~~",
    "..............................................................................................................~~.~~~~~~~~~~~~~",
    "..............................................................................................................~~~~~~~~~~~~~~~~",
    "...............................................................................................................~~~~~~~~~~~~~~~",
    "................................................................................................................~~~~~~~~~~~~~~",
    ".................................................................................................................~~~~~~~~~~~~~",
    ".................................................................................................................~~~~~~~~~~~~~",
    "..................................................................................................................~~~~~~~~~~~~",
    "...................................................................................................................~~~~~~~~~~~",
    "....................................................................................................................~~~~~~~~~~",
    ".....................................................................................................................~~~~~~~~~",
    "......................................................................................................................~~~~~~~~",
    "......................................................................................................................~~~~~~~~",
    ".......................................................................................................................~~~~~~~",
    ".......................................................................................................................~~~~~~~",
    "........................................................................................................................~~~~~~",
    ".........................................................................................................................~~~~~",
    "..........................................................................................................................~~~~",
    "...........................................................................................................................~~~",
    "............................................................................................................................~~",
    ".............................................................................................................................~",
    ".............................................................................................................................~",
    "..............................................................................................................................",
    "..............................................................................................................................",
    "..............................................................................................................................",
    "..............................................................................................................................",
    "..............................................................................................................................",
    "..............................................................................................................................",
    "..............................................................................................................................",
    "..............................................................................................................................",
    "..............................................................................................................................",
    "..............................................................................................................................",
    "..............................................................................................................................",
    "..............................................................................................................................",
    "..............................................................................................................................",
    "..............................................................................................................................",
    "..............................................................................................................................",
    "..............................................................................................................................",
    "..............................................................................................................................",
    "..............................................................................................................................",
    "..............................................................................................................................",
    "....................................................~~........................................................................",
    ".....................................................~~~~.....................................................................",
    ".........................######......................~.~~~....................................................................",
    ".........................######......................~~~~~~~~~~~~~.............................######.........................",
    ".........................######......................~~~..~~~~~~~~~............................######.........................",
    ".........................######......................~~~~~~.~~~~~~~~...........................######.........................",
    ".........................######.......................~~~~~.~~~~~~~~~..........................######.........................",
    ".........................######.......................~~~~~~~~~~~~~~~~.........................######.........................",
    ".........................######.....................~~~~~~..~~..~~.~.~.........................######.........................",
    ".........................######.....................~.~~~...~~~~.~~~.~~........................######.........................",
    ".........................######.....................~~~~~~.~~~.~.~~~~~~........................######.........................",
    ".........................######........................~~~~~~.~.~~~.~~~~~~.....................######.........................",
    ".........................######........................~~.~~~.~~~~...~~~.~.....................######.........................",
    ".........................######.........................~.~.~~..~~..~~~~~~.....................######.........................",
    ".........................######.........................~~~~~~~~~~~~~~~~.......................######.........................",
    ".........................######..........................~~~~~~~~~.~~~~~.......................######.........................",
    ".........................######...........................~~~~~~~~.~~~~~~......................######.........................",
    ".........................######............................~~~~~~~~~..~~~......................######.........................",
    ".........................######.............................~~~~~~~~~~~~~......................######.........................",
    "....................................................................~~~.~......................######.........................",
    ".....................................................................~~~~.....................................................",
    "........................................................................~~....................................................",
    "..............................................................................................................................",
    "..............................................................................................................................",
    "..............................................................................................................................",
    "..............................................................................................................................",
    "..............................................................................................................................",
    "..............................................................................................................................",
    "..............................................................................................................................",
    "..............................................................................................................................",
    "..............................................................................................................................",
    "..............................................................................................................................",
    "..............................................................................................................................",
    "..............................................................................................................................",
    "..............................................................................................................................",
    "..............................................................................................................................",
    "..............................................................................................................................",
    "..............................................................................................................................",
    "..............................................................................................................................",
    "..............................................................................................................................",
    "..............................................................................................................................",
    "~.............................................................................................................................",
    "~.............................................................................................................................",
    "~~............................................................................................................................",
    "~~~...........................................................................................................................",
    "~~~~..........................................................................................................................",
    "~~~~~.........................................................................................................................",
    "~~~~~~........................................................................................................................",
    "~~~~~~~.......................................................................................................................",
    "~~~~~~~.......................................................................................................................",
    "~~~~~~~~......................................................................................................................",
    "~~~~~~~~......................................................................................................................",
    "~~~~~~~~~.....................................................................................................................",
    "~~~~~~~~~~....................................................................................................................",
    "~~~~~~~~~~~...................................................................................................................",
    "~~~~~~~~~~~~..................................................................................................................",
    "~~~~~~~~~~~~~.................................................................................................................",
    "~~~~~~~~~~~~~.................................................................................................................",
    "~~~~~~~~~~~~~~................................................................................................................",
    "~~~~~~~~~~~~~~~...............................................................................................................",
    "~~~~~~~~~~~~~~~~..............................................................................................................",
    "~~~~~~~~~~~~~.~~..............................................................................................................",
    "~~~~~~~~~~~~~~~~..............................................................................................................",
    "~~~~~~~~~~~~~~~~~~............................................................................................................",
    "~~~~~~~~~~~~~~~~~~~~..........................................................................................................",
    "~~~~~~~~~~~~~~~~~~~~..........................................................................................................",
    "~~~~~~~~~~~~~~~~~~~~..........................................................................................................",
    "~~~~~~~~~~~~~~~~~~~~~.........................................................................................................",
    "~~~~~~~~~~~~~~~~~~~~~~........................................................................................................",
    "~~~~~~~~~~~~~~~~~~~~~~~.......................................................................................................",
    "~~~~~~~~~~~~~~~~~~~~~~~~......................................................................................................",
    "~~~~~~~~~~~~~~~~~~~~~~~~~~....................................................................................................",
    "~~~~~~~~~~~~~~~~~~~~~~~~~~~~..................................................................................................",
    "~~~~~~~~~~~~~~~~~~~~~~~~~~~~~~................................................................................................"
  ],
  "startLocations": [
    {
      "x": 9,
      "y": 9
    },
    {
      "x": 116,
      "y": 116
    }
  ],
  "baseSites": [
    {
      "x": 9,
      "y": 9
    },
    {
      "x": 116,
      "y": 116
    },
    {
      "x": 40,
      "y": 13
    },
    {
      "x": 46,
      "y": 112
    },
    {
      "x": 41,
      "y": 61
    },
    {
      "x": 84,
      "y": 64
    },
    {
      "x": 68,
      "y": 24
    },
    {
      "x": 57,
      "y": 101
    }
  ]
}
