{
  "version": 3,
  "name": "3 Player Map",
  "description": "3-way symmetry",
  "_design": "Flat map locations: startLocations choose player starts; every baseSites entry always spawns its resource cluster.",
  "terrain": [
    "~~~~~~~~~~~~~~~~~~~~~~~~~~~~~~~~~~~~~~~~~~~~~~~~~~~~................................................~~~~~~~~~~~~~~~~~~~~~~~~~~~~~~~~~~~~~~~~~~~~~~~~~~",
    "~~~~~~~~~~~~~~~~~~~~~~~~~~~~~~~~~~~~~~~~~~~~~.............................................................~~~~~~~~~~~~~~~~~~~~~~~~~~~~~~~~~~~~~~~~~~~~",
    "~~~~~~~~~~~~~~~~~~~~~~~~~~~~~~~~~~~~~.........................................................................~~~~~~~~~~~~~~~~~~~~~~~~~~~~~~~~~~~~~~~~",
    "~~~~~~~~~~~~~~~~~~~~~~~~~~~~~~~~~.................................................................................~~~~~~~~~~~~~~~~~~~~~~~~~~~~~~~~~~~~",
    "~~~~~~~~~~~~~~~~~~~~~~~~~~~~~~...........................................................................................~~~~~~~~~~~~~~~~~~~~~~~~~~~~~",
    "~~~~~~~~~~~~~~~~~~~~~~~~~~~~.................................................................................................~~~~~~~~~~~~~~~~~~~~~~~~~",
    "~~~~~~~~~~~~~~~~~~~~~~~~~~~...................................................................................................~~~~~~~~~~~~~~~~~~~~~~~~",
    "~~~~~~~~~~~~~~~~~~~~~~~~~.......................................................................................................~~~~~~~~~~~~~~~~~~~~~~",
    "~~~~~~~~~~~~~~~~~~~~~~~..........................................................................................................~~~~~~~~~~~~~~~~~~~~~",
    "~~~~~~~~~~~~~~~~~~~~~.............................................................................................................~~~~~~~~~~~~~~~~~~~~",
    "~~~~~~~~~~~~~~~~~~~.................................................................................................................~~~~~~~~~~~~~~~~~~",
    "~~~~~~~~~~~~~~~~~....................................................................................................................~~~~~~~~~~~~~~~~~",
    "~~~~~~~~~~~~~~~~......................................................................................................................~~~~~~~~~~~~~~~~",
    "~~~~~~~~~~~~~~.........................................................................................................................~~~~~~~~~~~~~~~",
    "~~~~~~~~~~~~~~...........................................................................................................................~~~~~~~~~~~~~",
    "~~~~~~~~~~~~~............................................................................................................................~~~~~~~~~~~~~",
    "~~~~~~~~~~~~..............................................................................................................................~~~~~~~~~~~~",
    "~~~~~~~~~~~................................................................................................................................~~~~~~~~~~~",
    "~~~~~~~~~~.................................................................................................................................~~~~~~~~~~~",
    "~~~~~~~~~~..................................................................................................................................~~~~~~~~~~",
    "~~~~~~~~~...................................................................................................................................~~~~~~~~~~",
    "~~~~~~~~.....................................................................................................................................~~~~~~~~~",
    "~~~~~~~......................................................................................................................................~~~~~~~~~",
    "~~~~~~~.......................................................................................................................................~~~~~~~~",
    "~~~~~~........................................................................................................................................~~~~~~~~",
    "~~~~~..........................................................................................................................................~~~~~~~",
    "~~~~~..........................................................................................................................................~~~~~~~",
    "~~~~~...........................................................................................................................................~~~~~~",
    "~~~~~............................................................................................................................................~~~~~",
    "~~~~.............................................................................................................................................~~~~~",
    "~~~~..............................................................................................................................................~~~~",
    "~~~~..............................................................................................................................................~~~~",
    "~~~~..............................................................................................................................................~~~~",
    "~~~~...............................................................................................................................................~~~",
    "~~~~...............................................................................................................................................~~~",
    "~~~~...............................................................................................................................................~~~",
    "~~~................................................................................................................................................~~~",
    "~~~.................................................................................................................................................~~",
    "~~~.................................................................................................................................................~~",
    "~~~.................................................................................................................................................~~",
    "~~..................................................................................................................................................~~",
    "~~..................................................................................................................................................~~",
    "~~.................................##..............................................................................##...............................~~",
    "~~.................................##.............................................................................###...............................~~",
    "~.................................###..............................................................................###..............................~~",
    "~.................................###...............................................................................##...............................~",
    "~...............................####................................................................................##...............................~",
    "~...............................###.................................................................................###..............................~",
    "~..............................###...................................................................................###.............................~",
    "~.............................###....................................................................................###.............................~",
    "..............................##......................................................................................##.............................~",
    ".............................###......................................................................................###............................~",
    "............................###.......................................................................................###.............................",
    "...........................###.........................................................................................##.............................",
    "..........................###..........................................................................................##.............................",
    "..........................###..........................................................................................###............................",
    "..........................##...........................................................................................####...........................",
    ".........................................................................................................................##...........................",
    "......................................................................................................................................................",
    "......................................................................................................................................................",
    "......................................................................~...............................................................................",
    "..................................................................~~~~~~..............................................................................",
    "................................................................~~~~~~~~~.............................................................................",
    "...............................................................~~......~~~~..~........................................................................",
    "..............................................................~~........~~~~~~~~~~~~~~................................................................",
    "..............................................................~.........~~~~~~~~~~~~~~~...............................................................",
    ".............................................................~~.......~~~.~~~~~~.....~~~~.............................................................",
    "............................................................~~~.....~~~~....~~~~~.....~~~~............................................................",
    ".............................................................~~.....~~~.......~~~~.....~~~............................................................",
    ".............................................................~~...~~~~..........~~~......~~...........................................................",
    ".............................................................~~....~~...........~~~~.....~~...........................................................",
    "............................................................~~~...~~~............~~~.....~~...........................................................",
    ".............................................................~~...~~~.............~~......~~..........................................................",
    "..............................................................~~.~~~..............~~~....~~...........................................................",
    "..............................................................~~~~~~..............~~~....~~...........................................................",
    "...............................................................~~~~~...............~~....~~...........................................................",
    "...............................................................~~~~~...............~~...~~~...........................................................",
    "...............................................................~~~~~...............~~.~~~~............................................................",
    "................................................................~~~~...............~~~~~~~............................................................",
    ".................................................................~~~.............~~~~~~...............................................................",
    ".................................................................~~~............~~~~~.................................................................",
    ".................................................................~~~~~~.....~.~~~~~~..................................................................",
    ".................................................................~~.~~~~~~~~~~~~~~~~..................................................................",
    ".................................................................~~..~~~~~~~~~~~~~~...................................................................",
    ".................................................................~~......~~.~...~~~...................................................................",
    "................................................................~~~............~~~....................................................................",
    ".................................................................~~............~~.....................................................................",
    "..................................................................~~~.........~~......................................................................",
    "...................................................................~~.......~~~~......................................................................",
    "....................................................................~~~...~~~~~.......................................................................",
    ".....................................................................~~~~~~~~.........................................................................",
    "........................................................................~.~...........................................................................",
    "......................................................................................................................................................",
    "......................................................................................................................................................",
    "......................................................................................................................................................",
    "......................................................................................................................................................",
    "......................................................................................................................................................",
    "......................................................................................................................................................",
    "~.....................................................................................................................................................",
    "~.....................................................................................................................................................",
    "~....................................................................................................................................................~",
    "~....................................................................................................................................................~",
    "~....................................................................................................................................................~",
    "~....................................................................................................................................................~",
    "~....................................................................................................................................................~",
    "~~...................................................................................................................................................~",
    "~~..................................................................................................................................................~~",
    "~~..................................................................................................................................................~~",
    "~~..................................................................................................................................................~~",
    "~~..................................................................................................................................................~~",
    "~~.................................................................................................................................................~~~",
    "~~.................................................................................................................................................~~~",
    "~~.................................................................................................................................................~~~",
    "~~~................................................................................................................................................~~~",
    "~~~...............................................................................................................................................~~~~",
    "~~~...............................................................................................................................................~~~~",
    "~~~...............................................................................................................................................~~~~",
    "~~~~..............................................................................................................................................~~~~",
    "~~~~..............................................................................................................................................~~~~",
    "~~~~..............................................................................................................................................~~~~",
    "~~~~~.............................................................................................................................................~~~~",
    "~~~~~............................................................................................................................................~~~~~",
    "~~~~~~...........................................................................................................................................~~~~~",
    "~~~~~~~............................................................######........................................................................~~~~~",
    "~~~~~~~...........................................................############...................................................................~~~~~",
    "~~~~~~~~..........................................................#.#.#############.............................................................~~~~~~",
    "~~~~~~~~...................................................................#########...........................................................~~~~~~~",
    "~~~~~~~~~......................................................................................................................................~~~~~~~",
    "~~~~~~~~~.....................................................................................................................................~~~~~~~~",
    "~~~~~~~~~~...................................................................................................................................~~~~~~~~~",
    "~~~~~~~~~~..................................................................................................................................~~~~~~~~~~",
    "~~~~~~~~~~~.................................................................................................................................~~~~~~~~~~",
    "~~~~~~~~~~~................................................................................................................................~~~~~~~~~~~",
    "~~~~~~~~~~~~..............................................................................................................................~~~~~~~~~~~~",
    "~~~~~~~~~~~~~............................................................................................................................~~~~~~~~~~~~~",
    "~~~~~~~~~~~~~...........................................................................................................................~~~~~~~~~~~~~~",
    "~~~~~~~~~~~~~~~.........................................................................................................................~~~~~~~~~~~~~~",
    "~~~~~~~~~~~~~~~~......................................................................................................................~~~~~~~~~~~~~~~~",
    "~~~~~~~~~~~~~~~~~....................................................................................................................~~~~~~~~~~~~~~~~~",
    "~~~~~~~~~~~~~~~~~~.................................................................................................................~~~~~~~~~~~~~~~~~~~",
    "~~~~~~~~~~~~~~~~~~~~.............................................................................................................~~~~~~~~~~~~~~~~~~~~~",
    "~~~~~~~~~~~~~~~~~~~~~..........................................................................................................~~~~~~~~~~~~~~~~~~~~~~~",
    "~~~~~~~~~~~~~~~~~~~~~~.......................................................................................................~~~~~~~~~~~~~~~~~~~~~~~~~",
    "~~~~~~~~~~~~~~~~~~~~~~~~...................................................................................................~~~~~~~~~~~~~~~~~~~~~~~~~~~",
    "~~~~~~~~~~~~~~~~~~~~~~~~~.................................................................................................~~~~~~~~~~~~~~~~~~~~~~~~~~~~",
    "~~~~~~~~~~~~~~~~~~~~~~~~~~~~~...........................................................................................~~~~~~~~~~~~~~~~~~~~~~~~~~~~~~",
    "~~~~~~~~~~~~~~~~~~~~~~~~~~~~~~~~~~~~.................................................................................~~~~~~~~~~~~~~~~~~~~~~~~~~~~~~~~~",
    "~~~~~~~~~~~~~~~~~~~~~~~~~~~~~~~~~~~~~~~~.........................................................................~~~~~~~~~~~~~~~~~~~~~~~~~~~~~~~~~~~~~",
    "~~~~~~~~~~~~~~~~~~~~~~~~~~~~~~~~~~~~~~~~~~~~.............................................................~~~~~~~~~~~~~~~~~~~~~~~~~~~~~~~~~~~~~~~~~~~~~",
    "~~~~~~~~~~~~~~~~~~~~~~~~~~~~~~~~~~~~~~~~~~~~~~~~~~................................................~~~~~~~~~~~~~~~~~~~~~~~~~~~~~~~~~~~~~~~~~~~~~~~~~~~~"
  ],
  "startLocations": [
    {
      "x": 22,
      "y": 43
    },
    {
      "x": 128,
      "y": 45
    },
    {
      "x": 73,
      "y": 136
    }
  ],
  "baseSites": [
    {
      "x": 22,
      "y": 43
    },
    {
      "x": 128,
      "y": 45
    },
    {
      "x": 73,
      "y": 136
    },
    {
      "x": 51,
      "y": 124
    },
    {
      "x": 43,
      "y": 29
    },
    {
      "x": 129,
      "y": 70
    },
    {
      "x": 97,
      "y": 125
    },
    {
      "x": 20,
      "y": 69
    },
    {
      "x": 107,
      "y": 30
    },
    {
      "x": 73,
      "y": 100
    },
    {
      "x": 53,
      "y": 60
    },
    {
      "x": 97,
      "y": 63
    }
  ]
}
