{
  "version": 3,
  "name": "4 Player Map",
  "description": "Four-player map with four corner starts and 12 neutral resource sites.",
  "_design": "Flat map locations: startLocations choose player starts; every baseSites entry always spawns its resource cluster.",
  "terrain": [
    "..............................................................................................................................",
    "..............................................................................................................................",
    "..............................................................................................................................",
    "..............................................................................................................................",
    "..............................................................................................................................",
    "..............................................................................................................................",
    "..............................................................................................................................",
    "..............................................................................................................................",
    "..............................................................................................................................",
    "..............................................................................................................................",
    "..............................................................................................................................",
    "..............................................................................................................................",
    "..............................................................................................................................",
    "..............................................................................................................................",
    "..............................................................................................................................",
    "..............................................................................................................................",
    "..............................................................................................................................",
    "..............................................................................................................................",
    ".............................................................~~~~~............................................................",
    "............................................................~~.~.~............................................................",
    "...........................................................~.~~~.~............................................................",
    "...........................................................~.~~~~~............................................................",
    "...........................................................~.~.~~.............................................................",
    "...........................................................~.~~~~.............................................................",
    "...........................................................~~~~~~.............................................................",
    "...........................................................~~~~~..............................................................",
    "...........................................................~~~~~..............................................................",
    "...........................................................~~..~..............................................................",
    "...........................................................~~~~~~.............................................................",
    "...........................................................~~~~.~.............................................................",
    "..........................................................~~~~~.~.............................................................",
    "..........................................................~~.~~~~.............................................................",
    "...........................................................~.~~~..............................................................",
    "...........................................................~~~~...............................................................",
    "...........................................................~~~~...............................................................",
    ".............................................................~................................................................",
    "..............................................................................................................................",
    "..............................................................................................................................",
    "..............................................................................................................................",
    "..............................................................................................................................",
    "..............................................................................................................................",
    "..............................................................................................................................",
    "..............................................................................................................................",
    "..............................................................................................................................",
    "..............................................................................................................................",
    "..............................................................................................................................",
    "..............................................................................................................................",
    "..............................................................................................................................",
    "..............................................................................................................................",
    "..............................................................................................................................",
    "..............................................................................................................................",
    "..............................................................................................................................",
    "..............................................................................................................................",
    "..............................................................................................................................",
    "..............................................................................................................................",
    "..............................................................................................................................",
    "..............................................................................................................................",
    "..............................................................................................................................",
    "..............................................................................................~~..............................",
    "...........................................................................................~~~~~~~~~~~~~~~....................",
    "..................~~~~.....................................................................~~..~~~~~~~....~...................",
    "..................~..~~~~...~~~~..........................................................~~~~~~~~.~~~~~~~~~..................",
    "..................~~~~~~~~~~~..~~..........................................................~~~~~~~.~~~~.~~.~..................",
    "..................~.~~.~~~~.~~~~~~~..........................................................~~..~~~~~~~~~~~..................",
    "..................~~~~~~~~~.~~~~~~~~..........................................................~~~~...~~~~..~..................",
    "...................~....~~~~~~~..~~.....................................................................~~~~..................",
    "....................~~~~~~~~~~~~~~~...........................................................................................",
    "..............................~~..............................................................................................",
    "..............................................................................................................................",
    "..............................................................................................................................",
    "..............................................................................................................................",
    "..............................................................................................................................",
    "..............................................................................................................................",
    "..............................................................................................................................",
    "..............................................................................................................................",
    "..............................................................................................................................",
    "..............................................................................................................................",
    "..............................................................................................................................",
    "..............................................................................................................................",
    "..............................................................................................................................",
    "..............................................................................................................................",
    "..............................................................................................................................",
    "..............................................................................................................................",
    "..............................................................................................................................",
    "..............................................................................................................................",
    "..............................................................................................................................",
    "..............................................................................................................................",
    "..............................................................................................................................",
    "..............................................................................................................................",
    "..............................................................................................................................",
    "................................................................~.............................................................",
    "...............................................................~~~~...........................................................",
    "...............................................................~~~~...........................................................",
    "..............................................................~~~.~...........................................................",
    ".............................................................~~~~.~~..........................................................",
    ".............................................................~.~~~~~..........................................................",
    ".............................................................~.~~~~...........................................................",
    ".............................................................~~~~~~...........................................................",
    "..............................................................~..~~...........................................................",
    "..............................................................~~~~~...........................................................",
    "..............................................................~~~~~...........................................................",
    ".............................................................~~~~~~...........................................................",
    ".............................................................~~~~.~...........................................................",
    ".............................................................~~.~.~...........................................................",
    "............................................................~~~~~.~...........................................................",
    "............................................................~.~~~.~...........................................................",
    "............................................................~.~.~~............................................................",
    "............................................................~~~~~.............................................................",
    "..............................................................................................................................",
    "..............................................................................................................................",
    "..............................................................................................................................",
    "..............................................................................................................................",
    "..............................................................................................................................",
    "..............................................................................................................................",
    "..............................................................................................................................",
    "..............................................................................................................................",
    "..............................................................................................................................",
    "..............................................................................................................................",
    "..............................................................................................................................",
    "..............................................................................................................................",
    "..............................................................................................................................",
    "..............................................................................................................................",
    "..............................................................................................................................",
    "..............................................................................................................................",
    "..............................................................................................................................",
    ".............................................................................................................................."
  ],
  "startLocations": [
    {
      "x": 9,
      "y": 9
    },
    {
      "x": 116,
      "y": 9
    },
    {
      "x": 116,
      "y": 116
    },
    {
      "x": 9,
      "y": 116
    }
  ],
  "baseSites": [
    {
      "x": 9,
      "y": 9
    },
    {
      "x": 116,
      "y": 9
    },
    {
      "x": 116,
      "y": 116
    },
    {
      "x": 9,
      "y": 116
    },
    {
      "x": 33,
      "y": 12
    },
    {
      "x": 113,
      "y": 33
    },
    {
      "x": 92,
      "y": 113
    },
    {
      "x": 12,
      "y": 92
    },
    {
      "x": 18,
      "y": 34
    },
    {
      "x": 91,
      "y": 18
    },
    {
      "x": 107,
      "y": 91
    },
    {
      "x": 34,
      "y": 107
    },
    {
      "x": 42,
      "y": 45
    },
    {
      "x": 80,
      "y": 42
    },
    {
      "x": 83,
      "y": 80
    },
    {
      "x": 45,
      "y": 83
    }
  ]
}
