{
  "name": "default-handcrafted",
  "terrain": [
    "..............................................................................................................................",
    "..............................................................................................................................",
    "..............................................................................................................................",
    "..............................................................................................................................",
    "..............................................................................................................................",
    "..............................................................................................................................",
    "..............................................................................................................................",
    "..............................................................................................................................",
    "..............................................................................................................................",
    "..............................................................................................................................",
    "..............................................................................................................................",
    "..............................................................................................................................",
    "..............................................................................................................................",
    "..............................................................................................................................",
    "..............................................................................................................................",
    "..............................................................~~~~~~..........................................................",
    "..............................................................~~~~~...........................................................",
    "..............................................................~~~~~...........................................................",
    "...............................................................~~~............................................................",
    "......................................................~~.......~~~...........~~~..............................................",
    "......................................................~~.......~~~..........~~.~..............................................",
    "......................................................~~........~~..........~~~~~~~...........................................",
    "......................................................~~........~~~........~~~~~~~~...........................................",
    ".....................................................~~~.........~~........~~~~~~~~...........................................",
    ".....................................................~~~........~~~........~~~~~~~~...........................................",
    "....................................................~.~~.......~~~~.......~~~~~...............................................",
    "...................................................~~~~........~~~.........~~~................................................",
    "...................................................~~~~.......~~~.........~~~~................................................",
    "..................................................~~~~.......~~~..........~~~~................................................",
    "..................................................~~~~.......~~~...........~~~................................................",
    "..................................................~~~~.......~~............~~~................................................",
    ".................................................~~~~........~~...~........~~~................................................",
    ".................................................~~~~........~~~~~~........~~~................................................",
    ".................................................~~~~..........~~~.........~~~~...............................................",
    ".................................................~~~~.......................~~~...............................................",
    "................................................~~~~~~......................~~~...............................................",
    "................................................~~..~~......................~~~...............................................",
    "....................................................~~~...................~~~~~...............................................",
    ".....................................................~~.......................~...............................................",
    ".....................................................~~.......................................................................",
    "..............................................................................................................................",
    "..............................................................................................................................",
    "..............................................................................................................................",
    "..............................................................................................................................",
    "..............................................................................................................................",
    "..............................................................................................................................",
    ".....................##.......................................................................................................",
    "...................#######.##.................................................................................................",
    "......................#######.#...............................................................................................",
    "..........................########............................................................................................",
    ".............................######...........................................................................................",
    ".................................#####.#######......................................#####################.....................",
    ".................####...............######..........................................#####################.....................",
    ".................#####...............###............................................#####################.....................",
    "...............###########..........................................................#####################.....................",
    "...............############...................................................................................................",
    "...............#############..................................................................................................",
    "...............###############................................................................................................",
    "...............############.###...............................................................................................",
    "...............###########...####.............................................................................................",
    "...............###########..#####.............................................................#################...............",
    ".................##....###...####.............................................................#################...............",
    "..................#....###....#...............................................................#################...............",
    "..................#....###....................................................................#################...............",
    "..............................................................................................................................",
    "..............................................................................................................................",
    "..............................................................................................................................",
    "..............................................................................................................................",
    "..............................................................................................................................",
    "..............................................................................................................................",
    "....................#####...........................................................#####################.....................",
    "..................##############....................................................#####################.....................",
    "..................################..................................................#####################.....................",
    "...................#.#####################..........................................#####################.....................",
    "......................##.###############......................................................................................",
    "..............................##.##...........................................................................................",
    "..............................................................................................................................",
    "..............................................................................................................................",
    "..............................................................................................................................",
    "..............................................................................................................................",
    "..............................................................................................................................",
    "..............................................................................................................................",
    "..............................................................................................................................",
    "..............................................................................................................................",
    "...................................................~~.....................~~~~................................................",
    "..................................................~~~~...................~...~................................................",
    ".................................................~~......................~~~~~................................................",
    "................................................~.~~~~...................~~...................................................",
    "................................................~~...~...................~~~..................................................",
    "................................................~~~~~~...................~.~~~~...............................................",
    ".................................................~.~~~...................~...~~...............................................",
    ".................................................~~..~...................~...~~~..............................................",
    ".................................................~~~~~~..................~~..~~...............................................",
    ".................................................~.~~~~...................~..~~...............................................",
    ".................................................~~~~.~....~~~~~~~........~..~~...............................................",
    ".................................................~....~....~.~..~~........~~~~~...............................................",
    ".................................................~~...~....~~~...~.......~~.~.~...............................................",
    "..................................................~~~.~.....~~.~~~.......~..~.~~..............................................",
    "..................................................~.~~~....~.~~.~~.......~.~~~.~..............................................",
    "..................................................~.~~~.....~~.~~........~.~.~.~..............................................",
    "..................................................~~~.~.....~...~........~~~.~~~..............................................",
    ".................................................~~...~.....~.~.~........~.~.~.~..............................................",
    ".................................................~~~..~.....~~~.~~.......~.~~~.~..............................................",
    ".................................................~.~~~~....~~..~~~.......~.....~..............................................",
    ".................................................~~.~~.....~~~~~.~~......~~...~~..............................................",
    "..................................................~~.......~...~~~~.......~~~~................................................",
    "...........................................................~~.~~~~............................................................",
    "...........................................................~~~~~..~~..........................................................",
    "..........................................................~~...~~..~~.........................................................",
    "..........................................................~~....~~~~..........................................................",
    "............................................................~~~~~.............................................................",
    "..............................................................................................................................",
    "..............................................................................................................................",
    "..............................................................................................................................",
    "..............................................................................................................................",
    "..............................................................................................................................",
    "..............................................................................................................................",
    "..............................................................................................................................",
    "..............................................................................................................................",
    "..............................................................................................................................",
    "..............................................................................................................................",
    "..............................................................................................................................",
    "..............................................................................................................................",
    "..............................................................................................................................",
    "..............................................................................................................................",
    ".............................................................................................................................."
  ],
  "baseSites": [
    {
      "x": 25,
      "y": 25
    },
    {
      "x": 63,
      "y": 38
    },
    {
      "x": 100,
      "y": 100
    },
    {
      "x": 63,
      "y": 88
    },
    {
      "x": 100,
      "y": 25
    },
    {
      "x": 88,
      "y": 62
    },
    {
      "x": 25,
      "y": 100
    },
    {
      "x": 38,
      "y": 62
    }
  ]
}
