{
  "name": "default-handcrafted",
  "terrain": [
    "................................................................................................",
    "................................................................................................",
    "................................................................................................",
    "................................................................................................",
    "................................................................................................",
    "................................................................................................",
    "................................................................................................",
    "................................................................................................",
    "................................................................................................",
    "................................................................................................",
    "................................................................................................",
    "................................................................................................",
    "................................................................................................",
    "................................................................................................",
    "................................................................................................",
    "................................................................................................",
    "................................................................................................",
    "................................................................................................",
    "................................................................................................",
    "................................................................................................",
    "................................................................................................",
    "....................................~......................~....................................",
    "..................................~~~~~..................~~~~~..................................",
    ".................................~~~~~~~................~~~~~~~.................................",
    "..................................~~~~~..................~~~~~..................................",
    "....................................~......................~....................................",
    "................................................................................................",
    "................................................................................................",
    "...............................#................................#...............................",
    ".............................#####............................#####.............................",
    "............................#######..........................#######............................",
    "...........................#########........................#########...........................",
    "............................#######..........................#######............................",
    ".............................#####............................#####.............................",
    "...............................#................................#...............................",
    "................................................................................................",
    "................................................................................................",
    "...........................................#........#...........................................",
    "..........................................###......###..........................................",
    ".........................................#####....#####.........................................",
    "..........................................###......###..........................................",
    "......................##...................#........#...................##......................",
    ".....................#####............................................#####.....................",
    "......................######....................~...................######......................",
    "........................#######............~~~.....~~~...........#######........................",
    "..........................#######........~~~~~.....~~~~~.......#######..........................",
    "............................#########...~~~~~~.....~~~~~~..#########............................",
    "...............................#######..~~~~~~.....~~~~~~.#######...............................",
    "...............................#######.~~~~~~~.....~~~~~~~#######...............................",
    "............................#########...~~~~~~.....~~~~~~..#########............................",
    "..........................#######.......~~~~~~.....~~~~~~......#######..........................",
    "........................#######..........~~~~~.....~~~~~.........#######........................",
    "......................######...............~~~.....~~~..............######......................",
    ".....................#####......................~.....................#####.....................",
    "......................##...................#........#...................##......................",
    "..........................................###......###..........................................",
    ".........................................#####....#####.........................................",
    "..........................................###......###..........................................",
    "...........................................#........#...........................................",
    "................................................................................................",
    "................................................................................................",
    "...............................#................................#...............................",
    ".............................#####............................#####.............................",
    "............................#######..........................#######............................",
    "...........................#########........................#########...........................",
    "............................#######..........................#######............................",
    ".............................#####............................#####.............................",
    "...............................#................................#...............................",
    "................................................................................................",
    "................................................................................................",
    "....................................~......................~....................................",
    "..................................~~~~~..................~~~~~..................................",
    ".................................~~~~~~~................~~~~~~~.................................",
    "..................................~~~~~..................~~~~~..................................",
    "....................................~......................~....................................",
    "................................................................................................",
    "................................................................................................",
    "................................................................................................",
    "................................................................................................",
    "................................................................................................",
    "................................................................................................",
    "................................................................................................",
    "................................................................................................",
    "................................................................................................",
    "................................................................................................",
    "................................................................................................",
    "................................................................................................",
    "................................................................................................",
    "................................................................................................",
    "................................................................................................",
    "................................................................................................",
    "................................................................................................",
    "................................................................................................",
    "................................................................................................",
    "................................................................................................",
    "................................................................................................"
  ],
  "baseSites": [
    { "x": 10, "y": 10 },
    { "x": 85, "y": 85 },
    { "x": 85, "y": 10 },
    { "x": 10, "y": 85 },
    { "x": 48, "y": 12 },
    { "x": 85, "y": 48 },
    { "x": 48, "y": 85 },
    { "x": 12, "y": 48 }
  ]
}
