{
  "name": "default-handcrafted",
  "terrain": [
    "..........................................................~~~~..................................",
    ".........................................................~~~....................................",
    "..............................................~~~......~~~~.....................................",
    ".............................................~~~~~....~~~~......................................",
    "............................................~~~~~.....~~~~......................................",
    "............................................~~~~.....~~~~.......................................",
    "...........................................~~~~......~~~........................................",
    "...........................................~~~......~~~~........................................",
    "..........................................~~~........~~~........................................",
    ".........................................~~~~.........~~........................................",
    "........................................~~~~..........~~........................................",
    ".......................................~~~~...........~~~.......................................",
    ".......................................~~~..............~~......................................",
    "......................................~~~~......................................................",
    "......................................~~~.......................................................",
    "......................................~~~.......................................................",
    "......................................~~........................................................",
    "......................................~.........................................................",
    "......................................~.........................................................",
    "......................................~.........................................................",
    "................................................................................................",
    "................................................................................................",
    "................................................................................................",
    "................................................................................................",
    "................................................................................................",
    "................................................................................................",
    "................................................................................................",
    "................................................................................................",
    "................................................................................................",
    "................................................................................................",
    "................................................................................................",
    "................................................................................................",
    "................................................................................................",
    "................................................................................................",
    "................................................................................................",
    "................................................................................................",
    ".......................................................~~.......................................",
    "..####....................................~~.~~~.....~~~~.......................................",
    "..#####..................................~~~~~~~~...~~~~........................................",
    "###########..............................~~~~~~~~...~~~~........................................",
    "############............................~~~~~~~~~~..~~~~........................................",
    "#############..........................~~~~~~~~~~~..~~~~~~~......................###########....",
    "#############.........................~.~~~~~~~~~~~~~~~~.~.......................#~~~~~~~~~#....",
    "############..........................~~~~~~~....~~~~~~~.........................#~~~##~~~##....",
    "###########............................~~~~~~....~~~~~~~~........................#~~#~~#~~#.....",
    "###########.............................~~~~~~~..~~~~~~~~~~~.....................#~~#~~#~~#.....",
    "..##....###.............................~~~~~~~~.~~~~~~~~~~~.....................#~~~##~~~##....",
    "...#....###.............................~~~~~~~~~~~~~~~~~~.......................#~~~~~~~~~#....",
    "...#....###.............................~~~~~~~~~~~~~~~~.........................###########....",
    ".........................................~~~~~~~~~~~~~~~~.......................................",
    ".........................................~~~~~~~~~~~~.~~~.......................................",
    "........................................~~...~~.~~~...~~~~......................................",
    "........................................~~~.....~~~~~~~~~~............................##########",
    ".........................................~~~~~~~~~~~~~~~~..........................####...#....#",
    "..........................................~~..~~~~~~~~.............................#......#....#",
    ".....#####...............................~~.~~~~~..................................#...........#",
    "...##############........................~~~.......................................#.....##.##.#",
    "...################................................................................#.....#..#..#",
    "....#.#################............................................................####..#..#..#",
    ".......##.##########.##...............................................................##########",
    "...............##.##............................................................................",
    "................................................................................................",
    "................................................................................................",
    "................................................................................................",
    "................................................................................................",
    "................................................................................................",
    "................................................................................................",
    "................................................................................................",
    "................................................................................................",
    "................................................................................................",
    "................................................................................................",
    "................................................................................................",
    "................................................................................................",
    "................................................................................................",
    "................................................................................................",
    "................................................................................................",
    "................................................................................................",
    "........................................................#.......................................",
    "........................................................#.......................................",
    "........................................................#.......................................",
    "........................................................##......................................",
    "........................................................##......................................",
    ".........................................####...........##......................................",
    ".......................................########.........###.....................................",
    "......................................##########........###.....................................",
    ".....................................############.......###.....................................",
    ".....................................############.......####....................................",
    "....................................##############......####....................................",
    "....................................##############......####....................................",
    "....................................##############......#####...................................",
    "....................................##############......#####...................................",
    ".....................................############.......######..................................",
    ".....................................############.......######..................................",
    "......................................##########................................................",
    ".......................................########.................................................",
    ".........................................####..................................................."
  ],
  "baseSites": [
    {
      "x": 10,
      "y": 10
    },
    {
      "x": 48,
      "y": 23
    },
    {
      "x": 85,
      "y": 85
    },
    {
      "x": 48,
      "y": 73
    },
    {
      "x": 85,
      "y": 10
    },
    {
      "x": 73,
      "y": 47
    },
    {
      "x": 10,
      "y": 85
    },
    {
      "x": 23,
      "y": 47
    }
  ]
}
