{
  "version": 1,
  "name": "default-handcrafted",
  "description": "4-player symmetrical map with a central lake. Standard competitive layout.",
  "_design": "4 base pairs in rotational symmetry around a central water feature. Each main has a close natural expansion. The lake forces flanking routes and creates a contested mid. Base protection radii are clear of water and rock.",
  "terrain": [
    "........................................................~~~~~~~~~~~~~~~~~~~~~.................................................",
    "........................................................~~~~~~~~~~~~~~~~~~~~~.................................................",
    "........................................................~~~~~~~~~~~~~~~~~~~~..................................................",
    "........................................................~~~~~~~~~~~~~~~~~~~~..................................................",
    "........................................................~~~~~~~~~~~~~~~~~~~~..................................................",
    ".........................................................~~~~~~~~~~~~~~~~~~...................................................",
    ".........................................................~~~~~~~~~~~~~~~~~....................................................",
    ".........................................................~~~~~~~~~~~~~~~~.....................................................",
    "..........................................................~~~~~~~~~~~~~~......................................................",
    "..........................................................~~~~~~~~~~~~~.......................................................",
    "...........................................................~~~~~~~~~~~........................................................",
    "...........................................................~~~~~~~~~~.........................................................",
    "............................................................~~~~~~~~~.........................................................",
    "............................................................~~~~~~~~..........................................................",
    ".............................................................~~~~~~~..........................................................",
    ".................................................~~~..........~~~~~~.............~~...........................................",
    ".................................................~~~~~........~~~~~.............~~............................................",
    ".................................................~~~~~........~~~~~............~~.............................................",
    "..................................................~~.~~........~~~............~~~.............................................",
    "..................................................~~..~........~~~...........~~~~.............................................",
    "......................................................~........~~~..........~~.~..............................................",
    "......................................................~.........~~..........~~~~~.............................................",
    "......................................................~.........~~~........~~~~~..............................................",
    ".....................................................~~..........~~........~~~~~..............................................",
    ".....................................................~~~........~~~........~~~~~..............................................",
    "....................................................~.~~........~~~.......~~~~~...............................................",
    "...................................................~~~~.........~~.........~~~................................................",
    "...................................................~~~~...................~~~~................................................",
    "..................................................~~~~....................~~~~................................................",
    "..................................................~~~~.....................~~~................................................",
    "..................................................~~~~.....................~~~................................................",
    ".................................................~~~~......................~~~................................................",
    ".................................................~~~~......................~~~................................................",
    ".................................................~~~~........................~~...............................................",
    "..............................................................................................................................",
    "..............................................................................................................................",
    "..............................................................................................................................",
    "..............................................................................................................................",
    "..............................................................................................................................",
    "..............................................................................................................................",
    "..............................................................................................................................",
    "..............................................................................................................................",
    "..............................................................................................................................",
    "...............#..............................................................................................................",
    "...............##.............................................................................................................",
    "...............###............................................................................................................",
    "................###..##.......................................................................................................",
    "..................########.##.................................................................................................",
    "......................#######.#...............................................................................................",
    "..........................#######.............................................................................................",
    ".............................#####...........................................................#################................",
    ".................................#...........................................................#################................",
    ".............................................................................................#################................",
    "...##.###....................................................................................#################................",
    "##############................................................................................................................",
    "#################.............................................................................................................",
    ".###################..........................................................................................................",
    "#########################.....................................................................................................",
    "#########################.....................................................................................................",
    "###.#.##################......................................................................................................",
    "##.###########.#########..............................................................................########################",
    ".####....#####...##....#..............................................................................########################",
    "........####.#........................................................................................########################",
    ".........####.........................................................................................########################",
    "......................................................................................................########################",
    "..............................................................................................................................",
    "..............................................................................................................................",
    "..............................................................................................................................",
    "..............................................................................................................................",
    "..............................................................................................................................",
    "....................#####.....................................................................................................",
    "................################.............................................................#################................",
    "...............###################...........................................................#################................",
    ".............###...#.#############...........................................................#################................",
    "......................##.#########...........................................................#################................",
    "..............................##.#............................................................................................",
    "..............................................................................................................................",
    "..............................................................................................................................",
    "..............................................................................................................................",
    "..............................................................................................................................",
    "..............................................................................................................................",
    "..............................................................................................................................",
    "..............................................................................................................................",
    "..............................................................................................................................",
    "..............................................................................................................................",
    "..............................................................................................................................",
    "..............................................................................................................................",
    "..............................................................................................................................",
    "..............................................................................................................................",
    "..............................................................................................................................",
    "..............................................................................................................................",
    "..............................................................................................................................",
    "...........................................................................~~~~...............................................",
    ".................................................~.~~~....................~..~~...............................................",
    ".................................................~~~~.~...................~..~~...............................................",
    ".................................................~....~...................~~~~~...............................................",
    ".................................................~~...~..................~~.~.~...............................................",
    "..................................................~~~.~..................~..~.~~..............................................",
    "..................................................~.~~~..................~.~~~.~..............................................",
    "..................................................~.~~~..................~.~.~.~..............................................",
    "..................................................~~~.~..................~~~.~~~..............................................",
    ".................................................~~...~..................~.~.~.~..............................................",
    ".................................................~~~..~........~~~.......~.~~~.~..............................................",
    ".................................................~.~~~~........~~~........~~...~..............................................",
    ".................................................~~.~~~.......~~.~.........~..~~~.............................................",
    "................................................~~~~~..........~~~~........~~~..~~............................................",
    "................................................~...~.........~~~~..........~~~..~............................................",
    "................................................~...~........~~~..~~........~~~~.~............................................",
    "................................................~~..~........~.~~..~~.......~.~~~~............................................",
    ".................................................~~~.........~..~~~~~........~~~~~............................................",
    ".................................................~~~~.......~~~~~~~~~~.........~~.............................................",
    "...................................................~........~....~.~.~........................................................",
    "............................................................~...~~.~.~~.......................................................",
    "............................................................~.~~.~~~..~.......................................................",
    "...........................................................~~~~..~~...~.......................................................",
    "...........................................................~~~~~~.~~...~......................................................",
    "..........................................................~~~~..~~~~~..~......................................................",
    "..........................................................~.~~...~~.~~.~......................................................",
    ".........................................................~~.~~.~~~...~~~......................................................",
    ".........................................................~..~.~~.~..~~~~......................................................",
    "........................................................~~..~~~~.~.~~.~~~.....................................................",
    ".......................................................~~.~~~..~.~~...~.~.....................................................",
    ".......................................................~.~~~~..~~~~...~..~....................................................",
    "......................................................~~.~~~...~~.~~~~~..~....................................................",
    "......................................................~....~~~~~~~~.~~~~~~....................................................",
    "......................................................~....~......~~~~...~...................................................."
  ],
  "baseSites": [
    {
      "x": 25,
      "y": 25
    },
    {
      "x": 63,
      "y": 38
    },
    {
      "x": 100,
      "y": 100
    },
    {
      "x": 63,
      "y": 88
    },
    {
      "x": 100,
      "y": 25
    },
    {
      "x": 88,
      "y": 62
    },
    {
      "x": 25,
      "y": 100
    },
    {
      "x": 38,
      "y": 62
    }
  ],
  "mainSites": [
    {
      "x": 25,
      "y": 25
    },
    {
      "x": 100,
      "y": 100
    },
    {
      "x": 100,
      "y": 25
    },
    {
      "x": 25,
      "y": 100
    }
  ],
  "naturalSites": [
    {
      "x": 63,
      "y": 38
    },
    {
      "x": 63,
      "y": 88
    },
    {
      "x": 88,
      "y": 62
    },
    {
      "x": 38,
      "y": 62
    }
  ],
  "naturalAssignments": [
    0,
    1,
    2,
    3
  ]
}
